R  1500  +800

NO cub/bluestone.xpm
SO cub/eagle.xpm
EA cub/redbrick.xpm
WE cub/graystone.xpm

S  cub/sprite_1.xpm
    F 255,128,10
C 76,202,255 





          
    1111111111111111
    1000000001100001
    1000000000000001
1111000000000111111
1000000000000001        11111111111
1110000S00000111        10000000001
1110000000000111        10000000001
1000000000011111        11111111111
100222222221
122222222221
100000000001
111111111111
                
    1111111111111111
    1000000001100001
    1000000000000001
1111000000000111111
1000000000000001        11111111111
1110000000000111        10000000001
1110000000000111        10000000001
1000000000011111        11111111111
100200000001
100000200001
100000000001
111111111111
         