
R 600 600
NO cub/bluestone.xpm
SO cub/ea.gle.xpm

    WE cub/gray             stone.xpm   
EA cub/redbrick.xpm
    S     cub/sprite_1.xpm     
F 1,1,1
C 225,30,0



1111111111111111
1000000000100001
10000S0000000001
1000000010000001
1000000100000001
1000001000011111
100200000001
100000200001
111110011111           
1111100111111
1000000000001
1000000000001
1000000000001
1000000000001
1000000000001    
1111111111111    
